#####################
#ooooooooo#ooooooooo#
#o###o###o#o###o###o#
#G#.#o#.#o#o#.#o#.#G#
#o###o###o#o###o###o#
#ooooooooooooooooooo#
#o###o#o#####o#o###o#
#ooooo#o#####o#ooooo#
#####o#ooo#ooo#o#####
....#o###.#.###o#....
....#o#.......#o#....
#####o#.##-##.#o#####
.....o..#...#..o.....
#####o#.#####.#o#####
....#o#.......#o#....
....#o#.#####.#o#....
#####o#o#####o#o#####
#ooooooooo#ooooooooo#
#o###o###o#o###o###o#
#Goo#ooooooooooo#ooG#
###o#o#o#####o#o#o###
###o#o#o#####o#o#o###
#ooooo#ooo#ooo#ooooo#
#o#######o#o#######o#
#ooooooooooooooooooo#
#####################