#####################
#ooooooooo#ooooooooo#
#o###o###o#o###o###o#
#G#.#o#.#o#o#.#o#.#G#
#o###o###o#o###o###o#
#ooooooooooooooooooo#
#o###o#o#####o#o###o#
#ooooo#o#####o#ooooo#
#####o#ooo#ooo#o#####
....#o###.#.###o#....
....#o#.......#o#....
#####o#.#---#.#o#####
.....o..#...#..o.....
#####o#.#####.#o#####
....#o#.......#o#....
....#o###.#.###o#....
#####o#ooo#ooo#o#####
#ooooo#o#####o#ooooo#
#o###o#o#####o#o###o#
#ooooooooooooooooooo#
#o###o###o#o###o###o#
#G#.#o#.#o#o#.#o#.#G#
#o###o###o#o###o###o#
#ooooooooo#ooooooooo#
#####################