#####################
#ooooooooo#ooooooooo#
#o###o###o#o###o###o#
#G#.#o#.#o#o#.#o#.#G#
#o###o###o#o###o###o#
#ooooooooooooooooooo#
#o#^#o#o#^^^#o#o#^#o#
#o#v#o#o#vvv#o#o#v#o#
#ooooo#ooo#ooo#ooooo#
#####o###o#o###o#####
....#o#.......#o#....
....#o#.##-##.#o#....
#####o#.#...#.#o#####
.....o..#...#..o.....
#####o#.#####.#o#####
....#o#.......#o#....
....#o#.#^^^#.#o#....
#####o#o#vvv#o#o#####
#ooooooooo#ooooooooo#
#o###o###o#o###o###o#
#Goo#ooooo.ooooo#ooG#
#^#o#o#o#^^^#o#o#o#^#
#v#o#o#o#vvv#o#o#o#v#
#ooooo#ooo#ooo#ooooo#
#o#######o#o#######o#
#ooooooooooooooooooo#
#####################